timestamp,price,volume,market_cap
1751893294254,0.03803062221476349,51699418.27162804,38233806.08677273
1751896987749,0.04010342736867514,51764383.560419455,39897089.27276204
1751900604323,0.03833536449375263,51497469.22665327,39270915.85596786
1751904227881,0.03318255359522237,51555219.62980333,33310542.39157578
1751907826897,0.030834943383643804,51254928.12315422,31331063.88729381
1751911428950,0.03042909594344262,49416906.06916875,31331063.88729381
1751915026203,0.030263453175524146,24239552.416369196,31331063.88729381
1751918626798,0.031224816439278325,20401601.050964706,31331063.88729381
1751922224517,0.031288761529611325,6971236.523450301,31331063.88729381
1751925814168,0.031794549139963824,3860439.409845833,31331063.88729381
1751929414586,0.03185109899686523,3004174.5855957307,31331063.88729381
1751932953460,0.03162461644043218,2326108.2276609293,31331063.88729381
1751936637272,0.03298588024448572,2165076.064540201,31331063.88729381
1751940219042,0.0317001509127133,1805232.6944181675,31331063.88729381
1751943768825,0.030669735474961095,1651388.89694077,31331063.88729381
1751947450212,0.028969096003756495,1484440.2121212804,31331063.88729381
1751950991869,0.029155242674129705,1382094.4701550293,31331063.88729381
1751954595087,0.028967776081360697,1291685.2262281552,31331063.88729381
1751958205684,0.02867020850251076,1064860.6711142787,31331063.88729381
1751961789694,0.028848659756215884,990155.9921615787,31331063.88729381
1751965424239,0.028420585338527628,844488.4691834754,31331063.88729381
1751969034548,0.028470351856755827,781091.0871160699,31331063.88729381
1751972620167,0.027565055846269445,641968.1174475756,31331063.88729381
1751976236846,0.02762798839894934,586632.7948174835,31331063.88729381
1751979809076,0.02768736874743736,489082.4176153893,31331063.88729381
1751983445995,0.026977809650971248,428698.05013555934,31331063.88729381
1751987050853,0.025819054494384666,378864.8771594333,31331063.88729381
1751990632028,0.02543897892087071,291498.92177741445,31331063.88729381
1751994211573,0.02555756524281041,227845.04111734533,31331063.88729381
1751997828476,0.025832978314823944,214803.5164427738,31331063.88729381
1752001424949,0.02598841545076209,207720.9424345523,31331063.88729381
1752005026662,0.025386983416155008,199412.54412356197,31331063.88729381
1752008630594,0.024884189579118147,170966.0946626522,31331063.88729381
1752012234033,0.02457858427885775,158435.5798065903,31331063.88729381
1752015842452,0.024581941123504227,151315.71835056192,31331063.88729381
1752019409183,0.024503481716039634,149957.25603331445,31331063.88729381
1752023014035,0.02445358533691495,134098.187567881,31331063.88729381
1752026635751,0.023575482732770676,111683.5723595435,31331063.88729381
1752030194061,0.02323676655768524,108624.91682505947,31331063.88729381
1752033797023,0.023149177948977067,97096.12890459025,31331063.88729381
1752037381638,0.02264720738746534,89141.7410870316,31331063.88729381
1752041002097,0.021741796262156828,96360.01340163154,31331063.88729381
1752044608189,0.021889367226350695,94415.10290304497,31331063.88729381
1752048214227,0.021651109086431742,75107.23936152185,31331063.88729381
1752051808016,0.02203640190191834,70637.29182622397,31331063.88729381
1752055411028,0.02199870791016424,69109.17777305217,31331063.88729381
1752058988043,0.025869154851223247,88528.01604957209,31331063.88729381
1752062597634,0.025292811528214863,90436.73704640452,31331063.88729381
1752066193962,0.024956721431885095,91531.41975796672,31331063.88729381
1752069729761,0.02502303623244611,87256.73101806304,31331063.88729381
1752073424957,0.025294607002921164,93062.36473582749,31331063.88729381
1752077006137,0.02304604517573796,101676.08905087192,31331063.88729381
1752080617931,0.023278654955332233,103577.30313223379,31331063.88729381
1752084229761,0.022941295961597042,98761.92821379167,31331063.88729381
1752087815953,0.02217378766970136,107508.94966536087,31331063.88729381
1752091419905,0.02267472176386371,107902.53295189439,31331063.88729381
1752094993243,0.02281486924478736,105673.79655285567,31331063.88729381
1752098631689,0.022813931928716474,106258.52959288537,31331063.88729381
1752102231967,0.022874256473387696,106357.05879568018,31331063.88729381
1752106097927,0.023111040900743295,107958.16782877625,31331063.88729381
1752109247887,0.02294585089826202,112364.4240954253,31331063.88729381
1752112839591,0.023233653522441625,108396.73149628796,31331063.88729381
1752116436358,0.022725439865736902,109524.52110278036,31331063.88729381
1752120031383,0.0226859836417555,108824.85910800018,31331063.88729381
1752123820658,0.02253269513425906,106556.9783741889,31331063.88729381
1752127433684,0.022637532583785595,100390.15815681595,31331063.88729381
1752131033728,0.022396557039862895,100527.14694056174,31331063.88729381
1752134636372,0.022307103853934276,98533.87248052312,31331063.88729381
1752138235046,0.022421887314074827,97691.48919143347,31331063.88729381
1752141828350,0.02227196496423226,96339.66628469026,31331063.88729381
1752145431491,0.02242961366136983,71946.13491975622,31331063.88729381
1752149034134,0.02240826659072572,67473.87437205718,31331063.88729381
1752152652155,0.022452116776527763,65704.28451884443,31331063.88729381
1752156241872,0.022546757083210148,65275.27140531947,31331063.88729381
1752159811707,0.02255090565574949,53055.5849392444,31331063.88729381
1752163455158,0.022258123933302548,41657.13953785675,31331063.88729381
1752167017031,0.022171087662173693,43106.08783104324,31331063.88729381
1752170621177,0.022199583347699663,43703.15636801636,31331063.88729381
1752174225324,0.02179081275918526,34089.945886465015,31331063.88729381
1752177811601,0.02188771068197793,33797.49233341328,31331063.88729381
1752181414328,0.020969426936021055,39397.51578586361,31331063.88729381
1752185015493,0.021417090013033473,38455.435471030876,31331063.88729381
1752188570397,0.021438077124373445,38719.38086461017,31331063.88729381
1752192178136,0.021419549906067096,34734.68918228806,31331063.88729381
1752195835149,0.021121777645062297,28774.54622893788,31331063.88729381
1752199428566,0.021196185432772068,35300.71513185655,31331063.88729381
1752203044621,0.02105346538499241,31808.786396229854,31331063.88729381
1752206628399,0.021156964725962464,30876.838512059727,31331063.88729381
1752210237418,0.021058174669095472,31308.865372872904,31331063.88729381
1752213839590,0.02108661523500573,29978.961485955086,31331063.88729381
1752217441613,0.020903416382564488,28369.549064910876,31331063.88729381
1752221029240,0.020972681735396823,33151.59862179026,31331063.88729381
1752224627556,0.020832232563943898,33396.79653534194,31331063.88729381
1752228230942,0.021364036362316815,35650.54996297883,31331063.88729381
1752231840746,0.021228091334088144,33537.75704428218,31331063.88729381
1752235422887,0.02113183990784599,33465.007549521106,31331063.88729381
1752239005008,0.02131137854744761,33415.816231167526,31331063.88729381
1752242598119,0.022217268603957147,38759.0480069787,31331063.88729381
1752246206569,0.02230362286084794,38752.70537934085,31331063.88729381
1752249801539,0.021870297064738625,37154.04859615821,31331063.88729381
1752253431263,0.02100119056449349,39230.060815779194,31331063.88729381
1752257030061,0.021051528381991348,37603.9222034316,31331063.88729381
1752260637294,0.021183926954566498,37371.919217689996,31331063.88729381
1752264228135,0.021170318207339014,37457.75495164048,31331063.88729381
1752267818501,0.02115263873277503,30491.78819565659,31331063.88729381
1752271421625,0.020863983761975295,30216.61676264391,31331063.88729381
1752275029038,0.020611429919269574,29591.20716974826,31331063.88729381
1752278630611,0.021182576588072047,30947.695478475052,31331063.88729381
1752282215983,0.021367492240278344,31474.87892573272,31331063.88729381
1752285813188,0.02155005074195318,30067.395480094317,31331063.88729381
1752289417263,0.02132526332894758,29745.099407612517,31331063.88729381
1752293018555,0.021430704529529505,29573.961383024827,31331063.88729381
1752296649379,0.02130020566684631,29061.156155548193,31331063.88729381
1752300220155,0.021427731428563426,28595.230587576167,31331063.88729381
1752303817322,0.02165274216854197,30777.11779540203,31331063.88729381
1752307431080,0.02327858787236401,36087.766849355896,31331063.88729381
1752311001153,0.02262878968687154,41715.903614641604,31331063.88729381
1752314606416,0.022634850479896423,39296.095123591826,31331063.88729381
1752318203466,0.022683766276298232,39251.95907283541,31331063.88729381
1752321808550,0.022615772806411617,39412.21121638291,31331063.88729381
1752325399724,0.022060662890246177,40879.76166844455,31331063.88729381
1752328991524,0.021939383277870605,37257.09721475598,31331063.88729381
1752332604607,0.021984555663261882,37231.6769898052,31331063.88729381
1752336198102,0.021704036222369615,39598.6026877278,31331063.88729381
1752339784158,0.021814628087395132,36401.23710224237,31331063.88729381
1752343342916,0.02192353765224549,36656.5246881704,31331063.88729381
1752346839267,0.02205580525220624,37347.368235852475,31331063.88729381
1752350592423,0.021954761910693472,37405.85861566261,31331063.88729381
1752354120707,0.02180593788253719,37663.59868085938,31331063.88729381
1752357736989,0.021880795171807754,37957.6117044174,31331063.88729381
1752361327043,0.02150929142785345,39912.967066307116,31331063.88729381
1752364933659,0.021578881443089726,38490.14742836092,31331063.88729381
1752368451966,0.021784933465397616,38881.840199320555,31331063.88729381
1752372040282,0.021780321861959696,32977.99544898926,31331063.88729381
1752375638761,0.021830673948224424,33162.83985661417,31331063.88729381
1752379235185,0.021933738416553206,33309.85851878534,31331063.88729381
1752382834085,0.021856075847318534,32962.47110476483,31331063.88729381
1752386436802,0.022021259792669105,35668.868208621236,31331063.88729381
1752390036980,0.022234898433221486,33746.090596062546,31331063.88729381
1752393634281,0.020739642823663217,32010.74318587001,31331063.88729381
1752397236201,0.020709060362783544,27647.01468412741,31331063.88729381
1752400841342,0.020673720630592075,27808.088846363746,31331063.88729381
1752404440195,0.020525436622927763,27353.82095928767,31331063.88729381
1752408032592,0.020368293799727627,28480.387487277305,31331063.88729381
1752411635209,0.020476257948488067,28810.20505845403,31331063.88729381
1752415233396,0.020576642405375056,28974.58310385622,31331063.88729381
1752418833763,0.020491264689794182,27843.380218052273,31331063.88729381
1752422440144,0.02050143573444026,24740.103570826348,31331063.88729381
1752426039935,0.02037997186912894,23337.320192970798,31331063.88729381
1752429641922,0.020509274924108846,23423.84921581574,31331063.88729381
1752433235119,0.021140197179710198,64007.22967304411,31331063.88729381
1752436838936,0.020583499718405743,68740.21942735846,31331063.88729381
1752440430045,0.02043222799533504,67779.70853252568,31331063.88729381
1752444219861,0.020393795874325008,67312.98419838301,31331063.88729381
1752447818173,0.020232318526751676,64976.18703102605,31331063.88729381
1752451414710,0.020228955945226054,64833.961522761645,31331063.88729381
1752455018163,0.020483005614424177,65269.6711773443,31331063.88729381
1752458615170,0.020600325246601065,65808.10602331356,31331063.88729381
1752462225968,0.02089944874252534,66585.65581062791,31331063.88729381
1752465850300,0.02116830844456615,67736.04524031332,31331063.88729381
1752469408649,0.021377286002009343,68338.48984139657,31331063.88729381
1752473024889,0.02093739701514879,65306.62756486034,31331063.88729381
1752476619819,0.02079170772310612,65077.74286883222,31331063.88729381
1752480214846,0.021046602811131396,55665.92274122069,31331063.88729381
1752483810096,0.021059880581460792,55666.847853260166,31331063.88729381
1752487412949,0.021032135942914976,55350.81833491413,31331063.88729381
1752491005682,0.02107647398779862,55098.42539030022,31331063.88729381
1752494619287,0.020912057014667383,53210.021941081155,31331063.88729381
1752498205003,0.020917854602984325,51964.276832394746,31331063.88729381
1752501805514,0.021495273864935396,52512.06909747039,31331063.88729381
1752505412591,0.021353589486578024,53241.94681694827,31331063.88729381
1752509009468,0.021302450354430572,52761.84584228832,31331063.88729381
1752512612105,0.021035779351844343,54477.47044890502,31331063.88729381
1752516230942,0.02068624241523197,56227.62385199213,31331063.88729381
1752519837742,0.020414011895253843,14108.615188156346,31331063.88729381
1752523431718,0.020740367012056917,9663.06768775518,31331063.88729381
1752527034082,0.021558467744952493,15106.176633738703,31331063.88729381
1752530623478,0.021253569696927994,15389.28542634726,31331063.88729381
1752534220484,0.021158402960865207,17036.842014427722,31331063.88729381
1752537818534,0.021193462640102488,18472.44209510184,31331063.88729381
1752541429193,0.021033997201332772,18200.567283495926,31331063.88729381
1752545025593,0.02214744359029051,26355.679778906262,31331063.88729381
1752548617246,0.02197751569961152,26243.0304629637,31331063.88729381
1752552230990,0.021566743802180894,26050.34985796725,31331063.88729381
1752555822953,0.02143679336553448,29120.39484792392,31331063.88729381
1752559431643,0.02146416575107599,28242.191116303537,31331063.88729381
1752563037686,0.021557770107827372,29474.11269569651,31331063.88729381
1752566651058,0.021588097925521327,29499.012283144606,31331063.88729381
1752570224427,0.021608099084482035,34383.71404632563,31331063.88729381
1752573853445,0.02155367204093006,34640.85583327917,31331063.88729381
1752577450803,0.02143238822556564,34355.09165710723,31331063.88729381
1752581022130,0.021131504752504318,38097.79434456223,31331063.88729381
1752584633782,0.020888076235754543,38345.47907751401,31331063.88729381
1752588218609,0.021343077933152547,37737.02667162862,31331063.88729381
1752591805628,0.020939229645508893,35367.274243054766,31331063.88729381
1752595410580,0.019977301052842195,43122.065944605405,31331063.88729381
1752599002663,0.020111477183023554,45278.34464095552,31331063.88729381
1752602612354,0.02033494508108209,42224.74572450115,31331063.88729381
1752606216068,0.020167914576746014,42418.936177347685,31331063.88729381
1752609804023,0.0199197344692053,41851.18571609255,31331063.88729381
1752613429021,0.020016826441080052,37090.49876744419,31331063.88729381
1752617032992,0.020071311780433775,36333.55347798118,31331063.88729381
1752620625964,0.02003494668851668,35001.531117734754,31331063.88729381
1752624234845,0.019872846999796186,36865.8517397192,31331063.88729381
1752627832706,0.020022368478569235,36671.47099442292,31331063.88729381
1752631443383,0.01980389069619048,34918.750729516854,31331063.88729381
1752635024382,0.019569684135860056,27748.90155427646,31331063.88729381
1752638635012,0.01972021561690026,27467.22749218073,31331063.88729381
1752642243028,0.01926905633410617,26383.33267844677,31331063.88729381
1752645834238,0.019319151833453452,26607.51684233604,31331063.88729381
1752649418094,0.019385157540773416,25456.134492280333,31331063.88729381
1752653028817,0.01965232894648705,25417.53685372587,31331063.88729381
1752656646946,0.019561820881037695,20249.32344889291,31331063.88729381
1752660242563,0.019350818385817727,23132.594156107647,31331063.88729381
1752663856383,0.019048821250647177,24695.29910939279,31331063.88729381
1752667449048,0.01915766652704381,21293.04008837321,31331063.88729381
1752671052139,0.019106903289591297,21010.96440076291,31331063.88729381
1752674655033,0.019180000830046437,20799.893900417228,31331063.88729381
1752678116725,0.019138967425064317,20755.394920591112,31331063.88729381
1752681719805,0.019077921687533653,13223.781631329377,31331063.88729381
1752685324285,0.01970349617144035,11564.599175957108,31331063.88729381
1752688930617,0.01980976005443182,13393.8214071315,31331063.88729381
1752692518683,0.01957173510941829,13042.181300418122,31331063.88729381
1752696117388,0.019683509006646102,13272.075605315258,31331063.88729381
1752699726119,0.019777410858324882,13241.464341906665,31331063.88729381
1752703343774,0.01964958141805661,13155.879378976808,31331063.88729381
1752706920724,0.019702016453769042,12808.141455374274,31331063.88729381
1752710520300,0.019674954139954032,10120.196050252114,31331063.88729381
1752714094802,0.019720863741152006,9765.954141836251,31331063.88729381
1752717723261,0.019442721801887126,9697.44080287098,31331063.88729381
1752721303158,0.01923848672046062,10082.659993654108,31331063.88729381
1752724919928,0.01898494253555099,10677.253990996349,31331063.88729381
1752728511845,0.019176495180642714,9229.57751702373,31331063.88729381
1752732120838,0.01926986163973248,8426.928913516833,31331063.88729381
1752735709832,0.019218095834945752,11670.255702537776,31331063.88729381
1752739312928,0.018849634912926485,12701.11357606284,31331063.88729381
1752742909042,0.018761816026300865,12805.148093062679,31331063.88729381
1752746509328,0.019156390483924726,10218.202642570395,31331063.88729381
1752750134878,0.01908185012613416,8574.109361596045,31331063.88729381
1752753733531,0.018947827072855916,8379.873825418323,31331063.88729381
1752757316871,0.019081211251424975,8073.522430267613,31331063.88729381
1752760917631,0.01888371496388769,7983.957877853171,31331063.88729381
1752764526040,0.018842270054565232,7966.435138767419,31331063.88729381
1752768114713,0.01879473639309323,7848.476128781884,31331063.88729381
1752771711055,0.018582440496409152,7676.616196093178,31331063.88729381
1752775321922,0.01880394647918944,6088.002463850767,31331063.88729381
1752778914807,0.018829235167796114,6227.177087350905,31331063.88729381
1752782515442,0.019020753141520103,7602.731957640995,31331063.88729381
1752786124468,0.019030257260067053,7553.818164354198,31331063.88729381
1752789721626,0.01938804446820462,7676.574046498493,31331063.88729381
1752793302141,0.019135197322253574,7625.063393128731,31331063.88729381
1752796914366,0.019225748630294616,7839.708533257479,31331063.88729381
1752800513203,0.019646637231111923,8029.094962157602,31331063.88729381
1752804100409,0.01977244955682532,8080.511349536256,31331063.88729381
1752807724372,0.019690680203206374,7512.11719433206,31331063.88729381
1752811291910,0.019792202582623084,6874.31587968616,31331063.88729381
1752814845144,0.01985677074355063,7620.825431176676,31331063.88729381
1752818517727,0.019992848310016156,7617.2375160892925,31331063.88729381
1752822147079,0.020000036026847186,4351.27965460606,31331063.88729381
1752825745269,0.019739391113741067,3189.747181983044,31331063.88729381
1752829322039,0.019516005655834025,3367.4765441603877,31331063.88729381
1752832923223,0.019301288873291803,4114.535898133483,31331063.88729381
1752836523128,0.019419726802332265,4736.354030948041,31331063.88729381
1752840106913,0.01919948384645081,5145.544393089427,31331063.88729381
1752843737395,0.019297551953010125,5303.956740884264,31331063.88729381
1752847322776,0.019614469287554677,5376.442726356086,31331063.88729381
1752850913321,0.019238491917703084,5318.068341589478,31331063.88729381
1752854529922,0.0189337620339474,5435.52775038838,31331063.88729381
1752858042010,0.019164218372530063,5599.609642461546,31331063.88729381
1752861723335,0.019323828687766546,5743.395428670892,31331063.88729381
1752865337858,0.01924931514131775,6150.683447704815,31331063.88729381
1752868915233,0.01905663536532237,4494.887697343106,31331063.88729381
1752872523985,0.018954675072784637,4465.916340062511,31331063.88729381
1752876121258,0.0190780043277564,4475.384139553268,31331063.88729381
1752879719127,0.019113942961341373,4483.814748330801,31331063.88729381
1752883328251,0.019136480741467746,4337.875588371882,31331063.88729381
1752886848108,0.018960346274861838,4286.264464883746,31331063.88729381
1752890533780,0.019065612438908322,4310.345754944552,31331063.88729381
1752894115457,0.01904892414750089,4306.8044021732285,31331063.88729381
1752897719077,0.019066738509482286,4241.794337328833,31331063.88729381
1752901322632,0.019171961532485397,3595.3808937787826,31331063.88729381
1752904837525,0.019181050499960113,3596.875162494591,31331063.88729381
1752908504273,0.018991609742247388,3444.6356343360826,31331063.88729381
1752912101806,0.01910426203746968,3430.6022663379304,31331063.88729381
1752915717065,0.01900324773934012,3113.552394689902,31331063.88729381
1752919311913,0.01897149530868398,2452.9578941814566,31331063.88729381
1752922919175,0.01902796317774251,1788.3027638538704,31331063.88729381
1752926507579,0.01919464113397841,1361.3145454698429,31331063.88729381
1752930100629,0.018964645158767734,2619.0998292862337,31331063.88729381
1752933712283,0.018957824496267494,2681.1139558848254,31331063.88729381
1752937319048,0.01866335806241661,2703.9541638953624,31331063.88729381
1752940915263,0.018806878033643747,2590.726129573324,31331063.88729381
1752942079000,0.018885141927325294,2601.2021739849606,31331063.88729381
