timestamp,price,volume,market_cap
1751893294254,0.03803062221476349,51699418.27162804,38233806.08677273
1751896987749,0.04010342736867514,51764383.560419455,39897089.27276204
1751900604323,0.03833536449375263,51497469.22665327,39270915.85596786
1751904227881,0.03318255359522237,51555219.62980333,33310542.39157578
1751907826897,0.030834943383643804,51254928.12315422,31331063.88729381
1751911428950,0.03042909594344262,49416906.06916875,31331063.88729381
1751915026203,0.030263453175524146,24239552.416369196,31331063.88729381
1751918626798,0.031224816439278325,20401601.050964706,31331063.88729381
1751922224517,0.031288761529611325,6971236.523450301,31331063.88729381
1751925814168,0.031794549139963824,3860439.409845833,31331063.88729381
1751929414586,0.03185109899686523,3004174.5855957307,31331063.88729381
1751932953460,0.03162461644043218,2326108.2276609293,31331063.88729381
1751936637272,0.03298588024448572,2165076.064540201,31331063.88729381
1751940219042,0.0317001509127133,1805232.6944181675,31331063.88729381
1751943768825,0.030669735474961095,1651388.89694077,31331063.88729381
1751947450212,0.028969096003756495,1484440.2121212804,31331063.88729381
1751950991869,0.029155242674129705,1382094.4701550293,31331063.88729381
1751954595087,0.028967776081360697,1291685.2262281552,31331063.88729381
1751958205684,0.02867020850251076,1064860.6711142787,31331063.88729381
1751961789694,0.028848659756215884,990155.9921615787,31331063.88729381
1751965424239,0.028420585338527628,844488.4691834754,31331063.88729381
1751969034548,0.028470351856755827,781091.0871160699,31331063.88729381
1751972620167,0.027565055846269445,641968.1174475756,31331063.88729381
1751976236846,0.02762798839894934,586632.7948174835,31331063.88729381
1751979809076,0.02768736874743736,489082.4176153893,31331063.88729381
1751983445995,0.026977809650971248,428698.05013555934,31331063.88729381
1751987050853,0.025819054494384666,378864.8771594333,31331063.88729381
1751990632028,0.02543897892087071,291498.92177741445,31331063.88729381
1751994211573,0.02555756524281041,227845.04111734533,31331063.88729381
1751997828476,0.025832978314823944,214803.5164427738,31331063.88729381
1752001424949,0.02598841545076209,207720.9424345523,31331063.88729381
1752005026662,0.025386983416155008,199412.54412356197,31331063.88729381
1752008630594,0.024884189579118147,170966.0946626522,31331063.88729381
1752012234033,0.02457858427885775,158435.5798065903,31331063.88729381
1752015842452,0.024581941123504227,151315.71835056192,31331063.88729381
1752019409183,0.024503481716039634,149957.25603331445,31331063.88729381
1752023014035,0.02445358533691495,134098.187567881,31331063.88729381
1752026635751,0.023575482732770676,111683.5723595435,31331063.88729381
1752030194061,0.02323676655768524,108624.91682505947,31331063.88729381
1752033797023,0.023149177948977067,97096.12890459025,31331063.88729381
1752037381638,0.02264720738746534,89141.7410870316,31331063.88729381
1752041002097,0.021741796262156828,96360.01340163154,31331063.88729381
1752044608189,0.021889367226350695,94415.10290304497,31331063.88729381
1752048214227,0.021651109086431742,75107.23936152185,31331063.88729381
1752051808016,0.02203640190191834,70637.29182622397,31331063.88729381
1752055411028,0.02199870791016424,69109.17777305217,31331063.88729381
1752058988043,0.025869154851223247,88528.01604957209,31331063.88729381
1752062597634,0.025292811528214863,90436.73704640452,31331063.88729381
1752066193962,0.024956721431885095,91531.41975796672,31331063.88729381
1752069729761,0.02502303623244611,87256.73101806304,31331063.88729381
1752073424957,0.025294607002921164,93062.36473582749,31331063.88729381
1752077006137,0.02304604517573796,101676.08905087192,31331063.88729381
1752080617931,0.023278654955332233,103577.30313223379,31331063.88729381
1752084229761,0.022941295961597042,98761.92821379167,31331063.88729381
1752087815953,0.02217378766970136,107508.94966536087,31331063.88729381
1752091419905,0.02267472176386371,107902.53295189439,31331063.88729381
1752094993243,0.02281486924478736,105673.79655285567,31331063.88729381
1752098631689,0.022813931928716474,106258.52959288537,31331063.88729381
1752102231967,0.022874256473387696,106357.05879568018,31331063.88729381
1752106097927,0.023111040900743295,107958.16782877625,31331063.88729381
1752109247887,0.02294585089826202,112364.4240954253,31331063.88729381
1752112839591,0.023233653522441625,108396.73149628796,31331063.88729381
1752116436358,0.022725439865736902,109524.52110278036,31331063.88729381
1752120031383,0.0226859836417555,108824.85910800018,31331063.88729381
1752123820658,0.02253269513425906,106556.9783741889,31331063.88729381
1752127433684,0.022637532583785595,100390.15815681595,31331063.88729381
1752131033728,0.022396557039862895,100527.14694056174,31331063.88729381
1752134636372,0.022307103853934276,98533.87248052312,31331063.88729381
1752138235046,0.022421887314074827,97691.48919143347,31331063.88729381
1752141828350,0.02227196496423226,96339.66628469026,31331063.88729381
1752145431491,0.02242961366136983,71946.13491975622,31331063.88729381
1752149034134,0.02240826659072572,67473.87437205718,31331063.88729381
1752152652155,0.022452116776527763,65704.28451884443,31331063.88729381
1752156241872,0.022546757083210148,65275.27140531947,31331063.88729381
1752159811707,0.02255090565574949,53055.5849392444,31331063.88729381
1752163455158,0.022258123933302548,41657.13953785675,31331063.88729381
1752167017031,0.022171087662173693,43106.08783104324,31331063.88729381
1752170621177,0.022199583347699663,43703.15636801636,31331063.88729381
1752174225324,0.02179081275918526,34089.945886465015,31331063.88729381
1752177811601,0.02188771068197793,33797.49233341328,31331063.88729381
1752181414328,0.020969426936021055,39397.51578586361,31331063.88729381
1752185015493,0.021417090013033473,38455.435471030876,31331063.88729381
1752188570397,0.021438077124373445,38719.38086461017,31331063.88729381
1752192178136,0.021419549906067096,34734.68918228806,31331063.88729381
1752195835149,0.021121777645062297,28774.54622893788,31331063.88729381
1752199428566,0.021196185432772068,35300.71513185655,31331063.88729381
1752203044621,0.02105346538499241,31808.786396229854,31331063.88729381
1752206628399,0.021156964725962464,30876.838512059727,31331063.88729381
1752210237418,0.021058174669095472,31308.865372872904,31331063.88729381
1752213839590,0.02108661523500573,29978.961485955086,31331063.88729381
1752217441613,0.020903416382564488,28369.549064910876,31331063.88729381
1752221029240,0.020972681735396823,33151.59862179026,31331063.88729381
1752224627556,0.020832232563943898,33396.79653534194,31331063.88729381
1752228230942,0.021364036362316815,35650.54996297883,31331063.88729381
1752231840746,0.021228091334088144,33537.75704428218,31331063.88729381
1752235422887,0.02113183990784599,33465.007549521106,31331063.88729381
1752239005008,0.02131137854744761,33415.816231167526,31331063.88729381
1752242598119,0.022217268603957147,38759.0480069787,31331063.88729381
1752246206569,0.02230362286084794,38752.70537934085,31331063.88729381
1752249801539,0.021870297064738625,37154.04859615821,31331063.88729381
1752253431263,0.02100119056449349,39230.060815779194,31331063.88729381
1752257030061,0.021051528381991348,37603.9222034316,31331063.88729381
1752260637294,0.021183926954566498,37371.919217689996,31331063.88729381
1752264228135,0.021170318207339014,37457.75495164048,31331063.88729381
1752267818501,0.02115263873277503,30491.78819565659,31331063.88729381
1752271421625,0.020863983761975295,30216.61676264391,31331063.88729381
1752275029038,0.020611429919269574,29591.20716974826,31331063.88729381
1752278630611,0.021182576588072047,30947.695478475052,31331063.88729381
1752282215983,0.021367492240278344,31474.87892573272,31331063.88729381
1752285813188,0.02155005074195318,30067.395480094317,31331063.88729381
1752289417263,0.02132526332894758,29745.099407612517,31331063.88729381
1752293018555,0.021430704529529505,29573.961383024827,31331063.88729381
1752296649379,0.02130020566684631,29061.156155548193,31331063.88729381
1752300220155,0.021427731428563426,28595.230587576167,31331063.88729381
1752303817322,0.02165274216854197,30777.11779540203,31331063.88729381
1752307431080,0.02327858787236401,36087.766849355896,31331063.88729381
1752311001153,0.02262878968687154,41715.903614641604,31331063.88729381
1752314606416,0.022634850479896423,39296.095123591826,31331063.88729381
1752318203466,0.022683766276298232,39251.95907283541,31331063.88729381
1752321808550,0.022615772806411617,39412.21121638291,31331063.88729381
1752325399724,0.022060662890246177,40879.76166844455,31331063.88729381
1752328991524,0.021939383277870605,37257.09721475598,31331063.88729381
1752332604607,0.021984555663261882,38608.729966195,31331063.88729381
1752333543000,0.022049000733741247,,31331063.88729381
